prior,0,1,2,total,max,max_pct
p,165396,14781,15211,195388,0,0.8465002968452515
p0,150744,7143,7495,165382,0,0.911489763093928
p1,7253,3228,4300,14781,0,0.49069751708274134
p2,7381,4410,3416,15207,0,0.4853685802590912
p00,142823,3856,4051,150730,0,0.9475419624494129
p01,5150,840,1153,7143,0,0.7209855802883942
p02,5275,1253,965,7493,0,0.7039903910316295
p10,3930,1440,1883,7253,0,0.54184475389494
p11,835,999,1394,3228,2,0.4318463444857497
p12,1247,1670,1381,4298,1,0.38855281526291297
p20,3975,1846,1560,7381,0,0.538544912613467
p21,1268,1389,1753,4410,2,0.3975056689342404
p22,859,1487,1070,3416,1,0.43530444964871196
p000,136309,3191,3312,142812,0,0.9544646108170182
p001,2943,400,513,3856,0,0.7632261410788381
p002,3059,552,439,4050,0,0.7553086419753087
p010,3050,927,1173,5150,0,0.5922330097087378
p011,318,212,310,840,0,0.37857142857142856
p012,516,347,289,1152,0,0.4479166666666667
p020,3098,1196,981,5275,0,0.5872985781990522
p021,533,326,394,1253,0,0.42537909018355946
p022,359,359,247,965,0,0.37202072538860104
p100,3238,283,409,3930,0,0.8239185750636132
p101,948,183,309,1440,0,0.6583333333333333
p102,1216,377,290,1883,0,0.6457780138077536
p110,321,200,314,835,0,0.3844311377245509
p111,203,339,457,999,2,0.4574574574574575
p112,344,550,500,1394,1,0.3945480631276901
p120,534,367,346,1247,0,0.4282277465918204
p121,400,557,713,1670,2,0.42694610778443115
p122,302,607,472,1381,1,0.4395365677045619
p200,3261,381,330,3972,0,0.8209969788519638
p201,1259,257,330,1846,0,0.6820151679306609
p202,999,324,236,1559,0,0.640795381654907
p210,559,313,396,1268,0,0.44085173501577285
p211,314,448,627,1389,2,0.4514038876889849
p212,387,773,592,1752,1,0.4412100456621005
p220,343,283,233,859,0,0.39930151338766007
p221,335,506,646,1487,2,0.4344317417619368
p222,198,521,351,1070,1,0.4869158878504673
p0000,131200,2461,2637,136298,0,0.962596663193884
p0001,2581,275,335,3191,0,0.8088373550611093
p0002,2679,347,285,3311,0,0.8091211114466929
p0010,2129,369,445,2943,0,0.7234114848793748
p0011,185,83,132,400,0,0.4625
p0012,297,123,92,512,0,0.580078125
p0020,2231,447,381,3059,0,0.7293233082706767
p0021,312,90,150,552,0,0.5652173913043478
p0022,208,124,107,439,0,0.47380410022779046
p0100,2680,153,217,3050,0,0.8786885245901639
p0101,772,64,91,927,0,0.8327939590075513
p0102,973,121,79,1173,0,0.8294970161977835
p0110,170,53,95,318,0,0.5345911949685535
p0111,61,57,94,212,2,0.44339622641509435
p0112,112,111,87,310,0,0.36129032258064514
p0120,290,119,107,516,0,0.562015503875969
p0121,115,100,132,347,2,0.3804034582132565
p0122,94,114,81,289,1,0.3944636678200692
p0200,2736,197,162,3095,0,0.8840064620355412
p0201,1011,77,108,1196,0,0.8453177257525084
p0202,805,99,77,981,0,0.8205912334352702
p0210,295,100,138,533,0,0.5534709193245778
p0211,96,96,134,326,2,0.4110429447852761
p0212,109,165,120,394,1,0.41878172588832485
p0220,191,96,72,359,0,0.532033426183844
p0221,114,111,134,359,2,0.3732590529247911
p0222,74,90,83,247,1,0.3643724696356275
p1000,2543,319,376,3238,0,0.7853613341568869
p1001,150,54,79,283,0,0.5300353356890459
p1002,216,116,77,409,0,0.5281173594132029
p1010,370,263,315,948,0,0.39029535864978904
p1011,49,59,75,183,2,0.4098360655737705
p1012,97,116,96,309,1,0.37540453074433655
p1020,486,390,340,1216,0,0.3996710526315789
p1021,121,119,137,377,2,0.363395225464191
p1022,94,125,71,290,1,0.43103448275862066
p1100,212,46,63,321,0,0.660436137071651
p1101,60,45,95,200,2,0.475
p1102,106,119,89,314,1,0.37898089171974525
p1110,57,65,81,203,2,0.39901477832512317
p1111,51,121,167,339,2,0.49262536873156343
p1112,103,184,170,457,1,0.4026258205689278
p1120,119,109,116,344,0,0.34593023255813954
p1121,109,211,230,550,2,0.41818181818181815
p1122,104,222,174,500,1,0.444
p1200,321,110,103,534,0,0.601123595505618
p1201,151,94,122,367,0,0.4114441416893733
p1202,118,141,87,346,1,0.407514450867052
p1210,135,114,151,400,2,0.3775
p1211,120,185,252,557,2,0.4524236983842011
p1212,157,320,236,713,1,0.4488078541374474
p1220,81,123,98,302,1,0.40728476821192056
p1221,122,215,270,607,2,0.44481054365733114
p1222,66,252,154,472,1,0.5338983050847458
p2000,2552,410,299,3261,0,0.7825820300521312
p2001,211,71,99,381,0,0.5538057742782152
p2002,164,89,77,330,0,0.49696969696969695
p2010,551,295,413,1259,0,0.43764892772041303
p2011,84,70,103,257,2,0.40077821011673154
p2012,122,108,100,330,0,0.3696969696969697
p2020,380,359,260,999,0,0.38038038038038036
p2021,100,117,107,324,1,0.3611111111111111
p2022,57,110,69,236,1,0.4661016949152542
p2100,346,84,129,559,0,0.6189624329159212
p2101,116,74,123,313,2,0.3929712460063898
p2102,137,137,122,396,0,0.34595959595959597
p2110,94,82,138,314,2,0.4394904458598726
p2111,91,161,196,448,2,0.4375
p2112,129,255,243,627,1,0.40669856459330145
p2120,125,139,123,387,1,0.35917312661498707
p2121,176,246,351,773,2,0.4540750323415265
p2122,104,271,217,592,1,0.4577702702702703
p2200,204,74,65,343,0,0.5947521865889213
p2201,97,86,100,283,2,0.35335689045936397
p2202,76,84,72,232,1,0.3620689655172414
p2210,129,99,107,335,0,0.3850746268656716
p2211,98,167,241,506,2,0.4762845849802372
p2212,121,288,236,645,1,0.44651162790697674
p2220,71,64,63,198,0,0.35858585858585856
p2221,99,180,242,521,2,0.46449136276391556
p2222,58,179,114,351,1,0.50997150997151
p00000,126754,2149,2287,131190,0,0.9661864471377392
p00001,1992,211,258,2461,0,0.8094270621698496
p00002,2131,274,231,2636,0,0.8084218512898331
p00010,1901,301,379,2581,0,0.736536226268888
p00011,144,53,78,275,0,0.5236363636363637
p00012,215,65,54,334,0,0.6437125748502994
p00020,1999,373,307,2679,0,0.746173945502053
p00021,223,42,82,347,0,0.6426512968299711
p00022,157,69,59,285,0,0.5508771929824562
p00100,1909,91,129,2129,0,0.8966651009863785
p00101,297,30,42,369,0,0.8048780487804879
p00102,355,58,32,445,0,0.797752808988764
p00110,123,20,42,185,0,0.6648648648648648
p00111,33,15,35,83,2,0.42168674698795183
p00112,57,41,34,132,0,0.4318181818181818
p00120,198,53,46,297,0,0.6666666666666666
p00121,54,34,35,123,0,0.43902439024390244
p00122,30,39,23,92,1,0.42391304347826086
p00200,1990,130,108,2228,0,0.8931777378815081
p00201,367,35,45,447,0,0.8210290827740492
p00202,297,49,35,381,0,0.7795275590551181
p00210,204,42,66,312,0,0.6538461538461539
p00211,42,24,24,90,0,0.4666666666666667
p00212,54,66,30,150,1,0.44
p00220,128,45,35,208,0,0.6153846153846154
p00221,52,35,37,124,0,0.41935483870967744
p00222,37,32,38,107,2,0.35514018691588783
p01000,2140,232,308,2680,0,0.7985074626865671
p01001,93,21,39,153,0,0.6078431372549019
p01002,134,49,34,217,0,0.6175115207373272
p01010,308,223,241,772,0,0.39896373056994816
p01011,22,17,25,64,2,0.390625
p01012,39,32,20,91,0,0.42857142857142855
p01020,393,314,266,973,0,0.4039054470709147
p01021,54,34,33,121,0,0.4462809917355372
p01022,35,25,19,79,0,0.4430379746835443
p01100,133,20,17,170,0,0.7823529411764706
p01101,17,12,24,53,2,0.4528301886792453
p01102,38,32,25,95,0,0.4
p01110,24,15,22,61,0,0.39344262295081966
p01111,12,19,26,57,2,0.45614035087719296
p01112,30,35,29,94,1,0.3723404255319149
p01120,50,34,28,112,0,0.44642857142857145
p01121,30,46,35,111,1,0.4144144144144144
p01122,26,35,26,87,1,0.40229885057471265
p01200,197,53,40,290,0,0.6793103448275862
p01201,60,28,31,119,0,0.5042016806722689
p01202,47,31,29,107,0,0.4392523364485981
p01210,49,24,42,115,0,0.4260869565217391
p01211,26,30,44,100,2,0.44
p01212,33,59,40,132,1,0.44696969696969696
p01220,33,34,27,94,1,0.3617021276595745
p01221,30,33,51,114,2,0.4473684210526316
p01222,15,43,23,81,1,0.5308641975308642
p02000,2179,326,231,2736,0,0.7964181286549707
p02001,120,30,47,197,0,0.6091370558375635
p02002,101,29,32,162,0,0.6234567901234568
p02010,435,239,337,1011,0,0.43026706231454004
p02011,28,19,30,77,2,0.38961038961038963
p02012,46,30,32,108,0,0.42592592592592593
p02020,314,281,210,805,0,0.39006211180124223
p02021,44,27,28,99,0,0.4444444444444444
p02022,19,34,24,77,1,0.44155844155844154
p02100,225,22,48,295,0,0.7627118644067796
p02101,42,20,38,100,0,0.42
p02102,54,45,39,138,0,0.391304347826087
p02110,34,25,37,96,2,0.3854166666666667
p02111,25,23,48,96,2,0.5
p02112,30,54,50,134,1,0.40298507462686567
p02120,54,33,22,109,0,0.4954128440366973
p02121,43,43,79,165,2,0.47878787878787876
p02122,32,53,35,120,1,0.44166666666666665
p02200,137,31,23,191,0,0.7172774869109948
p02201,46,21,29,96,0,0.4791666666666667
p02202,36,19,17,72,0,0.5
p02210,59,21,34,114,0,0.5175438596491229
p02211,30,35,46,111,2,0.4144144144144144
p02212,32,57,45,134,1,0.4253731343283582
p02220,34,22,18,74,0,0.4594594594594595
p02221,27,23,40,90,2,0.4444444444444444
p02222,19,36,28,83,1,0.43373493975903615
p10000,2209,138,196,2543,0,0.8686590640975226
p10001,247,33,39,319,0,0.774294670846395
p10002,307,36,33,376,0,0.8164893617021277
p10010,89,31,30,150,0,0.5933333333333334
p10011,16,17,21,54,2,0.3888888888888889
p10012,33,28,18,79,0,0.4177215189873418
p10020,129,38,49,216,0,0.5972222222222222
p10021,49,28,39,116,0,0.4224137931034483
p10022,27,28,22,77,1,0.36363636363636365
p10100,315,20,35,370,0,0.8513513513513513
p10101,227,15,21,263,0,0.8631178707224335
p10102,262,29,24,315,0,0.8317460317460318
p10110,18,13,18,49,0,0.3673469387755102
p10111,13,18,28,59,2,0.4745762711864407
p10112,20,31,24,75,1,0.41333333333333333
p10120,35,35,27,97,0,0.36082474226804123
p10121,30,40,46,116,2,0.39655172413793105
p10122,25,39,32,96,1,0.40625
p10200,424,33,29,486,0,0.8724279835390947
p10201,331,23,36,390,0,0.8487179487179487
p10202,290,27,23,340,0,0.8529411764705882
p10210,57,27,37,121,0,0.47107438016528924
p10211,28,34,57,119,2,0.4789915966386555
p10212,30,54,53,137,1,0.39416058394160586
p10220,35,33,26,94,0,0.3723404255319149
p10221,38,37,50,125,2,0.4
p10222,17,32,22,71,1,0.4507042253521127
p11000,155,28,29,212,0,0.7311320754716981
p11001,23,9,14,46,0,0.5
p11002,28,22,13,63,0,0.4444444444444444
p11010,19,15,26,60,2,0.43333333333333335
p11011,9,15,21,45,2,0.4666666666666667
p11012,28,35,32,95,1,0.3684210526315789
p11020,42,31,33,106,0,0.39622641509433965
p11021,26,38,55,119,2,0.46218487394957986
p11022,25,40,24,89,1,0.449438202247191
p11100,32,6,19,57,0,0.5614035087719298
p11101,20,10,35,65,2,0.5384615384615384
p11102,27,31,23,81,1,0.38271604938271603
p11110,9,19,23,51,2,0.45098039215686275
p11111,14,46,61,121,2,0.5041322314049587
p11112,31,59,77,167,2,0.46107784431137727
p11120,32,34,37,103,2,0.3592233009708738
p11121,34,67,83,184,2,0.45108695652173914
p11122,37,71,62,170,1,0.4176470588235294
p11200,61,27,31,119,0,0.5126050420168067
p11201,45,24,40,109,0,0.41284403669724773
p11202,40,48,28,116,1,0.41379310344827586
p11210,32,33,44,109,2,0.4036697247706422
p11211,44,62,105,211,2,0.4976303317535545
p11212,40,104,86,230,1,0.45217391304347826
p11220,25,39,40,104,2,0.38461538461538464
p11221,39,80,103,222,2,0.46396396396396394
p11222,26,92,56,174,1,0.5287356321839081
p12000,233,45,43,321,0,0.7258566978193146
p12001,58,24,28,110,0,0.5272727272727272
p12002,41,34,28,103,0,0.39805825242718446
p12010,68,31,52,151,0,0.4503311258278146
p12011,30,25,39,94,2,0.4148936170212766
p12012,42,42,38,122,0,0.3442622950819672
p12020,38,50,30,118,1,0.423728813559322
p12021,32,57,52,141,1,0.40425531914893614
p12022,23,38,26,87,1,0.4367816091954023
p12100,56,27,52,135,0,0.4148148148148148
p12101,42,30,42,114,0,0.3684210526315789
p12102,53,51,47,151,0,0.3509933774834437
p12110,33,29,58,120,2,0.48333333333333334
p12111,39,72,74,185,2,0.4
p12112,58,104,90,252,1,0.4126984126984127
p12120,41,57,59,157,2,0.37579617834394907
p12121,68,110,142,320,2,0.44375
p12122,37,107,92,236,1,0.4533898305084746
p12200,35,24,22,81,0,0.43209876543209874
p12201,31,40,52,123,2,0.42276422764227645
p12202,25,39,34,98,1,0.3979591836734694
p12210,35,45,42,122,1,0.36885245901639346
p12211,41,64,110,215,2,0.5116279069767442
p12212,50,113,106,269,1,0.4200743494423792
p12220,20,24,22,66,1,0.36363636363636365
p12221,47,87,118,252,2,0.46825396825396826
p12222,25,77,52,154,1,0.5
p20000,2228,172,151,2551,0,0.8733829870638965
p20001,342,31,37,410,0,0.8341463414634146
p20002,241,37,21,299,0,0.8060200668896321
p20010,139,36,36,211,0,0.6587677725118484
p20011,25,13,33,71,2,0.4647887323943662
p20012,49,30,20,99,0,0.494949494949495
p20020,103,36,25,164,0,0.6280487804878049
p20021,40,20,29,89,0,0.449438202247191
p20022,24,27,26,77,1,0.35064935064935066
p20100,456,42,53,551,0,0.8275862068965517
p20101,248,19,28,295,0,0.8406779661016949
p20102,356,34,23,413,0,0.8619854721549637
p20110,29,20,35,84,2,0.4166666666666667
p20111,15,24,31,70,2,0.44285714285714284
p20112,35,39,29,103,1,0.3786407766990291
p20120,57,31,34,122,0,0.4672131147540984
p20121,31,26,51,108,2,0.4722222222222222
p20122,38,36,26,100,0,0.38
p20200,322,34,24,380,0,0.8473684210526315
p20201,313,19,27,359,0,0.871866295264624
p20202,218,23,19,260,0,0.8384615384615385
p20210,34,31,35,100,2,0.35
p20211,26,38,53,117,2,0.452991452991453
p20212,25,45,37,107,1,0.4205607476635514
p20220,28,18,11,57,0,0.49122807017543857
p20221,24,39,47,110,2,0.42727272727272725
p20222,20,26,23,69,1,0.37681159420289856
p21000,248,59,39,346,0,0.7167630057803468
p21001,34,24,26,84,0,0.40476190476190477
p21002,54,45,30,129,0,0.4186046511627907
p21010,43,25,48,116,2,0.41379310344827586
p21011,18,27,29,74,2,0.3918918918918919
p21012,30,49,44,123,1,0.3983739837398374
p21020,51,45,41,137,0,0.3722627737226277
p21021,41,47,49,137,2,0.35766423357664234
p21022,34,60,28,122,1,0.4918032786885246
p21100,47,20,27,94,0,0.5
p21101,23,23,36,82,2,0.43902439024390244
p21102,41,56,41,138,1,0.4057971014492754
p21110,24,31,36,91,2,0.3956043956043956
p21111,25,56,80,161,2,0.4968944099378882
p21112,42,90,64,196,1,0.45918367346938777
p21120,37,41,51,129,2,0.3953488372093023
p21121,45,98,112,255,2,0.4392156862745098
p21122,41,116,86,243,1,0.4773662551440329
p21200,63,30,32,125,0,0.504
p21201,46,42,51,139,2,0.3669064748201439
p21202,31,62,30,123,1,0.5040650406504065
p21210,54,57,65,176,2,0.3693181818181818
p21211,50,93,103,246,2,0.4186991869918699
p21212,84,157,110,351,1,0.4472934472934473
p21220,23,50,31,104,1,0.4807692307692308
p21221,53,102,116,271,2,0.4280442804428044
p21222,25,117,75,217,1,0.5391705069124424
p22000,140,39,25,204,0,0.6862745098039216
p22001,33,17,24,74,0,0.44594594594594594
p22002,22,26,17,65,1,0.4
p22010,48,25,24,97,0,0.4948453608247423
p22011,26,26,34,86,2,0.3953488372093023
p22012,34,36,30,100,1,0.36
p22020,28,28,20,76,0,0.3684210526315789
p22021,24,33,27,84,1,0.39285714285714285
p22022,15,38,19,72,1,0.5277777777777778
p22100,65,35,29,129,0,0.5038759689922481
p22101,32,24,43,99,2,0.43434343434343436
p22102,30,41,36,107,1,0.38317757009345793
p22110,27,28,43,98,2,0.4387755102040816
p22111,27,66,74,167,2,0.4431137724550898
p22112,41,97,103,241,2,0.42738589211618255
p22120,30,49,42,121,1,0.4049586776859504
p22121,65,93,130,288,2,0.4513888888888889
p22122,35,111,90,236,1,0.4703389830508475
p22200,32,19,20,71,0,0.4507042253521127
p22201,20,25,19,64,1,0.390625
p22202,15,26,21,62,1,0.41935483870967744
p22210,35,33,31,99,0,0.35353535353535354
p22211,27,68,85,180,2,0.4722222222222222
p22212,39,118,85,242,1,0.48760330578512395
p22220,17,18,23,58,2,0.39655172413793105
p22221,25,70,84,179,2,0.4692737430167598
p22222,14,66,34,114,1,0.5789473684210527
p000000,122941,1852,1951,126744,0,0.9699946348545099
p000001,1820,145,184,2149,0,0.8469055374592834
p000002,1933,193,160,2286,0,0.8455818022747157
p000010,1568,194,230,1992,0,0.7871485943775101
p000011,113,41,57,211,0,0.5355450236966824
p000012,170,47,41,258,0,0.6589147286821705
p000020,1696,237,198,2131,0,0.7958704833411544
p000021,187,29,58,274,0,0.6824817518248175
p000022,128,53,50,231,0,0.5541125541125541
p000100,1737,67,97,1901,0,0.9137296159915834
p000101,264,11,26,301,0,0.8770764119601329
p000102,318,36,25,379,0,0.8390501319261213
p000110,104,15,25,144,0,0.7222222222222222
p000111,23,9,21,53,0,0.4339622641509434
p000112,42,18,18,78,0,0.5384615384615384
p000120,146,37,32,215,0,0.6790697674418604
p000121,33,15,17,65,0,0.5076923076923077
p000122,21,20,13,54,0,0.3888888888888889
p000200,1817,92,88,1997,0,0.9098647971957937
p000201,323,19,31,373,0,0.8659517426273459
p000202,262,26,19,307,0,0.8534201954397395
p000210,161,25,37,223,0,0.7219730941704036
p000211,21,11,10,42,0,0.5
p000212,34,37,11,82,1,0.45121951219512196
p000220,109,26,22,157,0,0.6942675159235668
p000221,31,16,22,69,0,0.4492753623188406
p000222,25,12,22,59,0,0.423728813559322
p001000,1646,106,157,1909,0,0.8622315348349922
p001001,64,12,15,91,0,0.7032967032967034
p001002,88,23,18,129,0,0.6821705426356589
p001010,171,53,73,297,0,0.5757575757575758
p001011,14,6,10,30,0,0.4666666666666667
p001012,20,13,9,42,0,0.47619047619047616
p001020,188,102,65,355,0,0.5295774647887324
p001021,32,12,14,58,0,0.5517241379310345
p001022,17,8,7,32,0,0.53125
p001100,102,11,10,123,0,0.8292682926829268
p001101,8,4,8,20,0,0.4
p001102,22,13,7,42,0,0.5238095238095238
p001110,16,7,10,33,0,0.48484848484848486
p001111,2,8,5,15,1,0.5333333333333333
p001112,17,9,9,35,0,0.4857142857142857
p001120,26,16,15,57,0,0.45614035087719296
p001121,15,19,7,41,1,0.4634146341463415
p001122,15,11,8,34,0,0.4411764705882353
p001200,149,30,19,198,0,0.7525252525252525
p001201,27,14,12,53,0,0.5094339622641509
p001202,22,11,13,46,0,0.4782608695652174
p001210,29,11,14,54,0,0.5370370370370371
p001211,9,7,18,34,2,0.5294117647058824
p001212,11,12,12,35,1,0.34285714285714286
p001220,14,9,7,30,0,0.4666666666666667
p001221,14,6,19,39,2,0.48717948717948717
p001222,4,15,4,23,1,0.6521739130434783
p002000,1677,185,128,1990,0,0.8427135678391959
p002001,89,17,24,130,0,0.6846153846153846
p002002,70,17,21,108,0,0.6481481481481481
p002010,234,54,79,367,0,0.6376021798365122
p002011,18,8,9,35,0,0.5142857142857142
p002012,18,15,12,45,0,0.4
p002020,175,67,55,297,0,0.5892255892255892
p002021,26,8,15,49,0,0.5306122448979592
p002022,10,11,14,35,2,0.4
p002100,159,14,31,204,0,0.7794117647058824
p002101,26,8,8,42,0,0.6190476190476191
p002102,27,19,20,66,0,0.4090909090909091
p002110,17,9,16,42,0,0.40476190476190477
p002111,9,2,13,24,2,0.5416666666666666
p002112,10,10,4,24,0,0.4166666666666667
p002120,35,9,10,54,0,0.6481481481481481
p002121,23,15,28,66,2,0.42424242424242425
p002122,5,14,11,30,1,0.4666666666666667
p002200,94,19,15,128,0,0.734375
p002201,28,8,9,45,0,0.6222222222222222
p002202,21,7,7,35,0,0.6
p002210,27,8,17,52,0,0.5192307692307693
p002211,14,5,16,35,2,0.45714285714285713
p002212,7,15,15,37,1,0.40540540540540543
p002220,24,8,5,37,0,0.6486486486486487
p002221,14,5,13,32,0,0.4375
p002222,8,18,12,38,1,0.47368421052631576
p010000,1894,104,142,2140,0,0.8850467289719626
p010001,202,15,15,232,0,0.8706896551724138
p010002,269,22,17,308,0,0.8733766233766234
p010010,60,17,16,93,0,0.6451612903225806
p010011,9,6,6,21,0,0.42857142857142855
p010012,18,14,7,39,0,0.46153846153846156
p010020,87,21,26,134,0,0.6492537313432836
p010021,25,9,15,49,0,0.5102040816326531
p010022,17,8,9,34,0,0.5
p010100,282,5,21,308,0,0.9155844155844156
p010101,207,6,10,223,0,0.9282511210762332
p010102,223,9,9,241,0,0.9253112033195021
p010110,11,4,7,22,0,0.5
p010111,5,5,7,17,2,0.4117647058823529
p010112,7,10,8,25,1,0.4
p010120,17,16,6,39,0,0.4358974358974359
p010121,9,12,11,32,1,0.375
p010122,7,6,7,20,0,0.35
p010200,368,14,11,393,0,0.9363867684478372
p010201,295,8,11,314,0,0.9394904458598726
p010202,251,10,5,266,0,0.943609022556391
p010210,32,10,12,54,0,0.5925925925925926
p010211,9,9,16,34,2,0.47058823529411764
p010212,6,14,13,33,1,0.42424242424242425
p010220,15,11,9,35,0,0.42857142857142855
p010221,10,4,11,25,2,0.44
p010222,6,6,7,19,2,0.3684210526315789
p011000,106,13,14,133,0,0.7969924812030075
p011001,11,3,6,20,0,0.55
p011002,8,6,3,17,0,0.47058823529411764
p011010,9,1,7,17,0,0.5294117647058824
p011011,3,3,6,12,2,0.5
p011012,9,11,4,24,1,0.4583333333333333
p011020,18,11,9,38,0,0.47368421052631576
p011021,7,10,15,32,2,0.46875
p011022,7,11,7,25,1,0.44
p011100,15,2,7,24,0,0.625
p011101,6,2,7,15,2,0.4666666666666667
p011102,9,4,9,22,0,0.4090909090909091
p011110,3,5,4,12,1,0.4166666666666667
p011111,3,10,6,19,1,0.5263157894736842
p011112,6,10,10,26,1,0.38461538461538464
p011120,14,9,7,30,0,0.4666666666666667
p011121,9,12,14,35,2,0.4
p011122,4,13,12,29,1,0.4482758620689655
p011200,30,9,11,50,0,0.6
p011201,15,8,11,34,0,0.4411764705882353
p011202,10,14,4,28,1,0.5
p011210,13,10,7,30,0,0.43333333333333335
p011211,13,10,23,46,2,0.5
p011212,5,14,16,35,2,0.45714285714285713
p011220,9,11,6,26,1,0.4230769230769231
p011221,4,15,16,35,2,0.45714285714285713
p011222,7,9,10,26,2,0.38461538461538464
p012000,150,21,26,197,0,0.7614213197969543
p012001,31,9,13,53,0,0.5849056603773585
p012002,21,8,11,40,0,0.525
p012010,34,11,15,60,0,0.5666666666666667
p012011,9,10,9,28,1,0.35714285714285715
p012012,14,5,12,31,0,0.45161290322580644
p012020,20,15,12,47,0,0.425531914893617
p012021,11,12,8,31,1,0.3870967741935484
p012022,12,11,6,29,0,0.41379310344827586
p012100,27,6,16,49,0,0.5510204081632653
p012101,10,4,10,24,0,0.4166666666666667
p012102,18,14,10,42,0,0.42857142857142855
p012110,10,6,10,26,0,0.38461538461538464
p012111,9,9,12,30,2,0.4
p012112,11,17,16,44,1,0.38636363636363635
p012120,12,13,8,33,1,0.3939393939393939
p012121,16,17,26,59,2,0.4406779661016949
p012122,4,23,13,40,1,0.575
p012200,19,8,6,33,0,0.5757575757575758
p012201,11,10,13,34,2,0.38235294117647056
p012202,10,10,7,27,0,0.37037037037037035
p012210,12,9,9,30,0,0.4
p012211,6,9,18,33,2,0.5454545454545454
p012212,7,21,22,50,2,0.44
p012220,7,4,4,15,0,0.4666666666666667
p012221,8,16,19,43,2,0.4418604651162791
p012222,2,14,7,23,1,0.6086956521739131
p020000,1930,125,123,2178,0,0.8861340679522498
p020001,292,16,18,326,0,0.8957055214723927
p020002,199,19,13,231,0,0.8614718614718615
p020010,87,14,19,120,0,0.725
p020011,8,6,16,30,2,0.5333333333333333
p020012,33,6,8,47,0,0.7021276595744681
p020020,68,19,14,101,0,0.6732673267326733
p020021,17,4,8,29,0,0.5862068965517241
p020022,7,12,13,32,2,0.40625
p020100,388,23,24,435,0,0.8919540229885058
p020101,219,10,10,239,0,0.9163179916317992
p020102,318,10,9,337,0,0.9436201780415431
p020110,16,6,6,28,0,0.5714285714285714
p020111,5,7,7,19,1,0.3684210526315789
p020112,11,14,5,30,1,0.4666666666666667
p020120,25,14,7,46,0,0.5434782608695652
p020121,13,5,12,30,0,0.43333333333333335
p020122,16,9,7,32,0,0.5
p020200,283,17,14,314,0,0.9012738853503185
p020201,269,4,8,281,0,0.9572953736654805
p020202,190,12,8,210,0,0.9047619047619048
p020210,24,9,11,44,0,0.5454545454545454
p020211,9,7,11,27,2,0.4074074074074074
p020212,9,11,8,28,1,0.39285714285714285
p020220,10,7,2,19,0,0.5263157894736842
p020221,13,10,11,34,0,0.38235294117647056
p020222,10,7,7,24,0,0.4166666666666667
p021000,176,29,20,225,0,0.7822222222222223
p021001,12,9,1,22,0,0.5454545454545454
p021002,29,11,8,48,0,0.6041666666666666
p021010,21,9,12,42,0,0.5
p021011,7,9,4,20,1,0.45
p021012,13,15,10,38,1,0.39473684210526316
p021020,23,17,14,54,0,0.42592592592592593
p021021,18,13,14,45,0,0.4
p021022,14,20,5,39,1,0.5128205128205128
p021100,14,8,12,34,0,0.4117647058823529
p021101,8,5,12,25,2,0.48
p021102,9,19,9,37,1,0.5135135135135135
p021110,7,6,12,25,2,0.48
p021111,5,8,10,23,2,0.43478260869565216
p021112,12,21,15,48,1,0.4375
p021120,14,6,10,30,0,0.4666666666666667
p021121,13,22,19,54,1,0.4074074074074074
p021122,11,28,11,50,1,0.56
p021200,34,9,11,54,0,0.6296296296296297
p021201,11,7,15,33,2,0.45454545454545453
p021202,3,13,6,22,1,0.5909090909090909
p021210,16,11,16,43,0,0.37209302325581395
p021211,9,15,19,43,2,0.4418604651162791
p021212,22,35,22,79,1,0.4430379746835443
p021220,9,16,7,32,1,0.5
p021221,8,17,28,53,2,0.5283018867924528
p021222,5,18,12,35,1,0.5142857142857142
p022000,102,20,15,137,0,0.7445255474452555
p022001,18,4,9,31,0,0.5806451612903226
p022002,11,5,7,23,0,0.4782608695652174
p022010,24,8,14,46,0,0.5217391304347826
p022011,5,4,12,21,2,0.5714285714285714
p022012,11,10,8,29,0,0.3793103448275862
p022020,17,10,9,36,0,0.4722222222222222
p022021,8,5,6,19,0,0.42105263157894735
p022022,3,9,5,17,1,0.5294117647058824
p022100,38,13,8,59,0,0.6440677966101694
p022101,7,6,8,21,2,0.38095238095238093
p022102,11,14,9,34,1,0.4117647058823529
p022110,12,9,9,30,0,0.4
p022111,5,14,16,35,2,0.45714285714285713
p022112,8,18,20,46,2,0.43478260869565216
p022120,7,19,6,32,1,0.59375
p022121,14,23,20,57,1,0.40350877192982454
p022122,6,21,18,45,1,0.4666666666666667
p022200,18,9,7,34,0,0.5294117647058824
p022201,11,4,7,22,0,0.5
p022202,3,8,7,18,1,0.4444444444444444
p022210,11,9,7,27,0,0.4074074074074074
p022211,4,7,12,23,2,0.5217391304347826
p022212,6,19,15,40,1,0.475
p022220,6,8,5,19,1,0.42105263157894735
p022221,6,12,18,36,2,0.5
p022222,5,19,4,28,1,0.6785714285714286
p100000,1901,115,193,2209,0,0.8605703938433681
p100001,73,30,35,138,0,0.5289855072463768
p100002,107,42,47,196,0,0.5459183673469388
p100010,141,38,68,247,0,0.5708502024291497
p100011,17,5,11,33,0,0.5151515151515151
p100012,21,12,6,39,0,0.5384615384615384
p100020,173,68,66,307,0,0.5635179153094463
p100021,19,6,11,36,0,0.5277777777777778
p100022,14,11,8,33,0,0.42424242424242425
p100100,71,7,11,89,0,0.797752808988764
p100101,15,4,12,31,0,0.4838709677419355
p100102,16,11,3,30,0,0.5333333333333333
p100110,9,1,6,16,0,0.5625
p100111,6,3,8,17,2,0.47058823529411764
p100112,6,10,5,21,1,0.47619047619047616
p100120,20,8,5,33,0,0.6060606060606061
p100121,9,12,7,28,1,0.42857142857142855
p100122,5,11,2,18,1,0.6111111111111112
p100200,92,25,12,129,0,0.7131782945736435
p100201,24,6,8,38,0,0.631578947368421
p100202,22,15,12,49,0,0.4489795918367347
p100210,26,10,13,49,0,0.5306122448979592
p100211,8,12,8,28,1,0.42857142857142855
p100212,9,18,12,39,1,0.46153846153846156
p100220,7,13,7,27,1,0.48148148148148145
p100221,13,9,6,28,0,0.4642857142857143
p100222,5,8,9,22,2,0.4090909090909091
p101000,214,38,63,315,0,0.6793650793650794
p101001,8,2,10,20,2,0.5
p101002,21,6,8,35,0,0.6
p101010,76,68,83,227,2,0.3656387665198238
p101011,6,4,5,15,0,0.4
p101012,7,10,4,21,1,0.47619047619047616
p101020,87,88,87,262,1,0.33587786259541985
p101021,11,10,8,29,0,0.3793103448275862
p101022,6,10,8,24,1,0.4166666666666667
p101100,13,2,3,18,0,0.7222222222222222
p101101,3,4,6,13,2,0.46153846153846156
p101102,8,6,4,18,0,0.4444444444444444
p101110,2,5,6,13,2,0.46153846153846156
p101111,3,4,11,18,2,0.6111111111111112
p101112,9,11,8,28,1,0.39285714285714285
p101120,10,6,4,20,0,0.5
p101121,4,13,14,31,2,0.45161290322580644
p101122,5,13,6,24,1,0.5416666666666666
p101200,19,7,9,35,0,0.5428571428571428
p101201,18,6,11,35,0,0.5142857142857142
p101202,9,9,9,27,0,0.3333333333333333
p101210,13,3,14,30,2,0.4666666666666667
p101211,10,17,13,40,1,0.425
p101212,8,21,17,46,1,0.45652173913043476
p101220,6,9,10,25,2,0.4
p101221,7,13,19,39,2,0.48717948717948717
p101222,6,14,12,32,1,0.4375
p102000,272,86,66,424,0,0.6415094339622641
p102001,17,6,10,33,0,0.5151515151515151
p102002,18,6,5,29,0,0.6206896551724138
p102010,111,77,143,331,2,0.43202416918429004
p102011,3,3,17,23,2,0.7391304347826086
p102012,19,7,10,36,0,0.5277777777777778
p102020,80,127,83,290,1,0.4379310344827586
p102021,11,8,8,27,0,0.4074074074074074
p102022,5,11,7,23,1,0.4782608695652174
p102100,37,6,14,57,0,0.6491228070175439
p102101,12,4,11,27,0,0.4444444444444444
p102102,10,13,14,37,2,0.3783783783783784
p102110,10,7,11,28,2,0.39285714285714285
p102111,10,9,15,34,2,0.4411764705882353
p102112,15,22,20,57,1,0.38596491228070173
p102120,12,13,5,30,1,0.43333333333333335
p102121,8,13,33,54,2,0.6111111111111112
p102122,16,23,14,53,1,0.4339622641509434
p102200,24,5,6,35,0,0.6857142857142857
p102201,10,9,14,33,2,0.42424242424242425
p102202,12,8,6,26,0,0.46153846153846156
p102210,19,6,13,38,0,0.5
p102211,8,14,15,37,2,0.40540540540540543
p102212,11,20,19,50,1,0.4
p102220,4,7,6,17,1,0.4117647058823529
p102221,9,11,12,32,2,0.375
p102222,6,7,9,22,2,0.4090909090909091
p110000,120,12,23,155,0,0.7741935483870968
p110001,10,8,10,28,0,0.35714285714285715
p110002,17,5,7,29,0,0.5862068965517241
p110010,13,7,3,23,0,0.5652173913043478
p110011,2,2,5,9,2,0.5555555555555556
p110012,8,4,2,14,0,0.5714285714285714
p110020,13,6,9,28,0,0.4642857142857143
p110021,11,7,4,22,0,0.5
p110022,4,7,2,13,1,0.5384615384615384
p110100,11,4,4,19,0,0.5789473684210527
p110101,8,3,4,15,0,0.5333333333333333
p110102,15,6,5,26,0,0.5769230769230769
p110110,2,4,3,9,1,0.4444444444444444
p110111,3,4,8,15,2,0.5333333333333333
p110112,6,8,7,21,1,0.38095238095238093
p110120,7,10,11,28,2,0.39285714285714285
p110121,8,9,18,35,2,0.5142857142857142
p110122,8,11,13,32,2,0.40625
p110200,24,9,9,42,0,0.5714285714285714
p110201,13,7,11,31,0,0.41935483870967744
p110202,22,5,6,33,0,0.6666666666666666
p110210,7,10,9,26,1,0.38461538461538464
p110211,6,12,20,38,2,0.5263157894736842
p110212,9,24,22,55,1,0.43636363636363634
p110220,8,8,9,25,2,0.36
p110221,10,14,16,40,2,0.4
p110222,3,14,7,24,1,0.5833333333333334
p111000,22,4,6,32,0,0.6875
p111001,4,1,1,6,0,0.6666666666666666
p111002,6,8,5,19,1,0.42105263157894735
p111010,3,4,13,20,2,0.65
p111011,2,2,6,10,2,0.6
p111012,8,15,12,35,1,0.42857142857142855
p111020,10,8,9,27,0,0.37037037037037035
p111021,6,12,13,31,2,0.41935483870967744
p111022,3,9,11,23,2,0.4782608695652174
p111100,6,2,1,9,0,0.6666666666666666
p111101,7,4,8,19,2,0.42105263157894735
p111102,7,10,6,23,1,0.43478260869565216
p111110,5,4,5,14,0,0.35714285714285715
p111111,7,19,20,46,2,0.43478260869565216
p111112,5,24,32,61,2,0.5245901639344263
p111120,7,14,10,31,1,0.45161290322580644
p111121,11,19,29,59,2,0.4915254237288136
p111122,20,29,28,77,1,0.37662337662337664
p111200,16,3,13,32,0,0.5
p111201,13,7,14,34,2,0.4117647058823529
p111202,12,16,9,37,1,0.43243243243243246
p111210,10,11,13,34,2,0.38235294117647056
p111211,12,16,39,67,2,0.582089552238806
p111212,10,35,38,83,2,0.4578313253012048
p111220,7,13,17,37,2,0.4594594594594595
p111221,12,26,33,71,2,0.4647887323943662
p111222,9,40,13,62,1,0.6451612903225806
p112000,43,11,7,61,0,0.7049180327868853
p112001,14,3,10,27,0,0.5185185185185185
p112002,10,9,12,31,2,0.3870967741935484
p112010,15,8,22,45,2,0.4888888888888889
p112011,8,7,9,24,2,0.375
p112012,8,20,12,40,1,0.5
p112020,12,17,11,40,1,0.425
p112021,8,14,26,48,2,0.5416666666666666
p112022,5,12,11,28,1,0.42857142857142855
p112100,14,8,10,32,0,0.4375
p112101,10,9,14,33,2,0.42424242424242425
p112102,20,12,12,44,0,0.45454545454545453
p112110,8,9,27,44,2,0.6136363636363636
p112111,12,19,31,62,2,0.5
p112112,18,47,40,105,1,0.44761904761904764
p112120,11,14,15,40,2,0.375
p112121,23,39,42,104,2,0.40384615384615385
p112122,7,38,41,86,2,0.47674418604651164
p112200,7,6,12,25,2,0.48
p112201,9,14,16,39,2,0.41025641025641024
p112202,8,16,16,40,1,0.4
p112210,8,18,13,39,1,0.46153846153846156
p112211,16,20,44,80,2,0.55
p112212,19,49,35,103,1,0.47572815533980584
p112220,9,7,10,26,2,0.38461538461538464
p112221,14,30,48,92,2,0.5217391304347826
p112222,10,26,20,56,1,0.4642857142857143
p120000,184,33,16,233,0,0.7896995708154506
p120001,21,9,15,45,0,0.4666666666666667
p120002,24,13,6,43,0,0.5581395348837209
p120010,31,16,11,58,0,0.5344827586206896
p120011,10,6,8,24,0,0.4166666666666667
p120012,8,15,5,28,1,0.5357142857142857
p120020,21,13,7,41,0,0.5121951219512195
p120021,12,9,13,34,2,0.38235294117647056
p120022,10,11,7,28,1,0.39285714285714285
p120100,41,11,16,68,0,0.6029411764705882
p120101,15,4,12,31,0,0.4838709677419355
p120102,28,14,10,52,0,0.5384615384615384
p120110,6,7,17,30,2,0.5666666666666667
p120111,4,6,15,25,2,0.6
p120112,13,13,13,39,0,0.3333333333333333
p120120,19,7,16,42,0,0.4523809523809524
p120121,8,11,23,42,2,0.5476190476190477
p120122,8,19,11,38,1,0.5
p120200,24,8,6,38,0,0.631578947368421
p120201,29,10,11,50,0,0.58
p120202,15,10,5,30,0,0.5
p120210,5,10,17,32,2,0.53125
p120211,11,21,25,57,2,0.43859649122807015
p120212,8,24,20,52,1,0.46153846153846156
p120220,14,6,3,23,0,0.6086956521739131
p120221,4,13,21,38,2,0.5526315789473685
p120222,7,8,11,26,2,0.4230769230769231
p121000,36,12,8,56,0,0.6428571428571429
p121001,9,5,13,27,2,0.48148148148148145
p121002,14,23,15,52,1,0.4423076923076923
p121010,10,9,23,42,2,0.5476190476190477
p121011,7,8,15,30,2,0.5
p121012,8,12,22,42,2,0.5238095238095238
p121020,17,19,17,53,1,0.3584905660377358
p121021,13,17,21,51,2,0.4117647058823529
p121022,10,24,13,47,1,0.5106382978723404
p121100,18,7,8,33,0,0.5454545454545454
p121101,6,9,14,29,2,0.4827586206896552
p121102,15,21,22,58,2,0.3793103448275862
p121110,11,13,15,39,2,0.38461538461538464
p121111,9,27,36,72,2,0.5
p121112,16,33,25,74,1,0.44594594594594594
p121120,13,19,26,58,2,0.4482758620689655
p121121,19,43,42,104,1,0.41346153846153844
p121122,14,47,29,90,1,0.5222222222222223
p121200,15,10,16,41,2,0.3902439024390244
p121201,18,16,23,57,2,0.40350877192982454
p121202,22,23,14,59,1,0.3898305084745763
p121210,18,25,25,68,1,0.36764705882352944
p121211,23,41,46,110,2,0.41818181818181815
p121212,31,64,47,142,1,0.4507042253521127
p121220,5,17,15,37,1,0.4594594594594595
p121221,24,38,45,107,2,0.4205607476635514
p121222,8,52,32,92,1,0.5652173913043478
p122000,20,8,7,35,0,0.5714285714285714
p122001,9,7,8,24,0,0.375
p122002,6,9,7,22,1,0.4090909090909091
p122010,14,10,7,31,0,0.45161290322580644
p122011,12,15,13,40,1,0.375
p122012,14,21,17,52,1,0.40384615384615385
p122020,8,10,7,25,1,0.4
p122021,10,14,15,39,2,0.38461538461538464
p122022,6,17,11,34,1,0.5
p122100,17,9,9,35,0,0.4857142857142857
p122101,10,10,25,45,2,0.5555555555555556
p122102,13,15,14,42,1,0.35714285714285715
p122110,7,12,22,41,2,0.5365853658536586
p122111,13,21,30,64,2,0.46875
p122112,19,41,50,110,2,0.45454545454545453
p122120,12,17,21,50,2,0.42
p122121,27,35,51,113,2,0.45132743362831856
p122122,18,47,41,106,1,0.44339622641509435
p122200,8,4,8,20,0,0.4
p122201,5,13,6,24,1,0.5416666666666666
p122202,8,8,5,21,0,0.38095238095238093
p122210,17,15,15,47,0,0.3617021276595745
p122211,12,31,44,87,2,0.5057471264367817
p122212,15,60,43,118,1,0.5084745762711864
p122220,8,6,11,25,2,0.44
p122221,10,31,36,77,2,0.4675324675324675
p122222,6,29,17,52,1,0.5576923076923077
p200000,1903,182,143,2228,0,0.854129263913824
p200001,97,36,39,172,0,0.563953488372093
p200002,88,39,24,151,0,0.5827814569536424
p200010,192,69,81,342,0,0.5614035087719298
p200011,14,7,10,31,0,0.45161290322580644
p200012,23,6,7,36,0,0.6388888888888888
p200020,130,68,43,241,0,0.5394190871369294
p200021,17,7,13,37,0,0.4594594594594595
p200022,15,5,1,21,0,0.7142857142857143
p200100,101,17,21,139,0,0.7266187050359713
p200101,17,15,4,36,0,0.4722222222222222
p200102,21,11,4,36,0,0.5833333333333334
p200110,10,4,11,25,2,0.44
p200111,4,3,6,13,2,0.46153846153846156
p200112,9,13,11,33,1,0.3939393939393939
p200120,32,8,9,49,0,0.6530612244897959
p200121,12,7,11,30,0,0.4
p200122,4,8,8,20,1,0.4
p200200,81,13,8,102,0,0.7941176470588235
p200201,20,10,6,36,0,0.5555555555555556
p200202,13,8,4,25,0,0.52
p200210,17,7,16,40,0,0.425
p200211,13,1,6,20,0,0.65
p200212,11,11,7,29,0,0.3793103448275862
p200220,12,6,6,24,0,0.5
p200221,8,10,9,27,1,0.37037037037037035
p200222,7,12,7,26,1,0.46153846153846156
p201000,280,88,88,456,0,0.6140350877192983
p201001,21,7,14,42,0,0.5
p201002,25,20,8,53,0,0.4716981132075472
p201010,61,102,85,248,1,0.4112903225806452
p201011,2,7,10,19,2,0.5263157894736842
p201012,12,9,7,28,0,0.42857142857142855
p201020,118,124,114,356,1,0.34831460674157305
p201021,11,12,11,34,1,0.35294117647058826
p201022,12,7,4,23,0,0.5217391304347826
p201100,18,7,4,29,0,0.6206896551724138
p201101,6,4,10,20,2,0.5
p201102,8,13,14,35,2,0.4
p201110,6,3,6,15,0,0.4
p201111,7,7,10,24,2,0.4166666666666667
p201112,4,15,12,31,1,0.4838709677419355
p201120,14,12,9,35,0,0.4
p201121,11,14,14,39,1,0.358974358974359
p201122,6,11,12,29,2,0.41379310344827586
p201200,29,16,12,57,0,0.5087719298245614
p201201,15,8,8,31,0,0.4838709677419355
p201202,16,11,7,34,0,0.47058823529411764
p201210,7,10,14,31,2,0.45161290322580644
p201211,7,6,13,26,2,0.5
p201212,14,26,11,51,1,0.5098039215686274
p201220,13,15,10,38,1,0.39473684210526316
p201221,9,14,13,36,1,0.3888888888888889
p201222,5,14,7,26,1,0.5384615384615384
p202000,230,55,37,322,0,0.7142857142857143
p202001,14,7,13,34,0,0.4117647058823529
p202002,12,6,6,24,0,0.5
p202010,90,108,115,313,2,0.36741214057507987
p202011,7,8,4,19,1,0.42105263157894735
p202012,9,8,10,27,2,0.37037037037037035
p202020,59,87,72,218,1,0.39908256880733944
p202021,7,11,5,23,1,0.4782608695652174
p202022,4,12,3,19,1,0.631578947368421
p202100,29,2,3,34,0,0.8529411764705882
p202101,4,8,19,31,2,0.6129032258064516
p202102,17,13,5,35,0,0.4857142857142857
p202110,7,9,10,26,2,0.38461538461538464
p202111,6,12,20,38,2,0.5263157894736842
p202112,5,22,26,53,2,0.49056603773584906
p202120,7,11,7,25,1,0.44
p202121,12,15,18,45,2,0.4
p202122,11,16,10,37,1,0.43243243243243246
p202200,19,7,2,28,0,0.6785714285714286
p202201,8,4,6,18,0,0.4444444444444444
p202202,3,4,4,11,1,0.36363636363636365
p202210,13,7,4,24,0,0.5416666666666666
p202211,8,16,15,39,1,0.41025641025641024
p202212,14,22,11,47,1,0.46808510638297873
p202220,6,7,7,20,1,0.35
p202221,4,7,15,26,2,0.5769230769230769
p202222,5,11,7,23,1,0.4782608695652174
p210000,195,22,31,248,0,0.7862903225806451
p210001,35,10,14,59,0,0.5932203389830508
p210002,21,9,9,39,0,0.5384615384615384
p210010,16,7,11,34,0,0.47058823529411764
p210011,5,9,10,24,2,0.4166666666666667
p210012,7,10,9,26,1,0.38461538461538464
p210020,29,11,14,54,0,0.5370370370370371
p210021,13,12,20,45,2,0.4444444444444444
p210022,6,13,11,30,1,0.43333333333333335
p210100,22,11,10,43,0,0.5116279069767442
p210101,12,6,7,25,0,0.48
p210102,24,14,10,48,0,0.5
p210110,5,5,8,18,2,0.4444444444444444
p210111,5,9,13,27,2,0.48148148148148145
p210112,7,13,9,29,1,0.4482758620689655
p210120,11,9,10,30,0,0.36666666666666664
p210121,13,19,17,49,1,0.3877551020408163
p210122,10,22,12,44,1,0.5
p210200,32,10,9,51,0,0.6274509803921569
p210201,23,8,14,45,0,0.5111111111111111
p210202,17,12,12,41,0,0.4146341463414634
p210210,18,7,16,41,0,0.43902439024390244
p210211,13,13,21,47,2,0.44680851063829785
p210212,15,16,18,49,2,0.3673469387755102
p210220,12,14,8,34,1,0.4117647058823529
p210221,18,19,23,60,2,0.38333333333333336
p210222,8,12,8,28,1,0.42857142857142855
p211000,27,11,9,47,0,0.574468085106383
p211001,8,5,7,20,0,0.4
p211002,14,8,5,27,0,0.5185185185185185
p211010,7,10,6,23,1,0.43478260869565216
p211011,4,10,9,23,1,0.43478260869565216
p211012,11,9,16,36,2,0.4444444444444444
p211020,14,12,15,41,2,0.36585365853658536
p211021,13,16,27,56,2,0.48214285714285715
p211022,15,20,6,41,1,0.4878048780487805
p211100,11,2,11,24,0,0.4583333333333333
p211101,7,4,20,31,2,0.6451612903225806
p211102,11,17,8,36,1,0.4722222222222222
p211110,1,10,14,25,2,0.56
p211111,4,17,35,56,2,0.625
p211112,20,25,35,80,2,0.4375
p211120,11,11,20,42,2,0.47619047619047616
p211121,14,36,40,90,2,0.4444444444444444
p211122,13,29,22,64,1,0.453125
p211200,15,15,7,37,0,0.40540540540540543
p211201,17,9,15,41,0,0.4146341463414634
p211202,18,18,15,51,0,0.35294117647058826
p211210,9,12,24,45,2,0.5333333333333333
p211211,19,36,43,98,2,0.4387755102040816
p211212,25,55,32,112,1,0.49107142857142855
p211220,9,15,17,41,2,0.4146341463414634
p211221,23,39,54,116,2,0.46551724137931033
p211222,10,43,33,86,1,0.5
p212000,40,13,10,63,0,0.6349206349206349
p212001,13,12,5,30,0,0.43333333333333335
p212002,10,17,5,32,1,0.53125
p212010,19,12,15,46,0,0.41304347826086957
p212011,13,8,21,42,2,0.5
p212012,20,17,14,51,0,0.39215686274509803
p212020,6,18,7,31,1,0.5806451612903226
p212021,13,31,18,62,1,0.5
p212022,6,15,9,30,1,0.5
p212100,15,13,26,54,2,0.48148148148148145
p212101,22,17,18,57,0,0.38596491228070173
p212102,15,25,25,65,1,0.38461538461538464
p212110,15,14,21,50,2,0.42
p212111,18,44,31,93,1,0.4731182795698925
p212112,29,40,34,103,1,0.3883495145631068
p212120,18,30,36,84,2,0.42857142857142855
p212121,29,54,74,157,2,0.4713375796178344
p212122,26,46,38,110,1,0.41818181818181815
p212200,9,10,4,23,1,0.43478260869565216
p212201,11,16,23,50,2,0.46
p212202,7,13,11,31,1,0.41935483870967744
p212210,15,18,20,53,2,0.37735849056603776
p212211,19,35,48,102,2,0.47058823529411764
p212212,24,43,49,116,2,0.4224137931034483
p212220,4,13,8,25,1,0.52
p212221,25,41,51,117,2,0.4358974358974359
p212222,13,37,25,75,1,0.49333333333333335
p220000,114,14,12,140,0,0.8142857142857143
p220001,29,6,4,39,0,0.7435897435897436
p220002,18,5,2,25,0,0.72
p220010,21,6,6,33,0,0.6363636363636364
p220011,7,1,9,17,2,0.5294117647058824
p220012,8,9,7,24,1,0.375
p220020,14,4,4,22,0,0.6363636363636364
p220021,11,7,8,26,0,0.4230769230769231
p220022,7,4,6,17,0,0.4117647058823529
p220100,27,8,13,48,0,0.5625
p220101,14,5,6,25,0,0.56
p220102,10,10,4,24,0,0.4166666666666667
p220110,7,7,12,26,2,0.46153846153846156
p220111,6,11,9,26,1,0.4230769230769231
p220112,11,12,11,34,1,0.35294117647058826
p220120,13,10,11,34,0,0.38235294117647056
p220121,10,10,16,36,2,0.4444444444444444
p220122,14,8,8,30,0,0.4666666666666667
p220200,15,9,4,28,0,0.5357142857142857
p220201,15,5,8,28,0,0.5357142857142857
p220202,13,1,6,20,0,0.65
p220210,5,12,7,24,1,0.5
p220211,6,10,17,33,2,0.5151515151515151
p220212,8,10,9,27,1,0.37037037037037035
p220220,4,5,6,15,2,0.4
p220221,7,16,15,38,1,0.42105263157894735
p220222,3,11,5,19,1,0.5789473684210527
p221000,36,18,11,65,0,0.5538461538461539
p221001,13,10,12,35,0,0.37142857142857144
p221002,11,11,7,29,0,0.3793103448275862
p221010,12,7,13,32,2,0.40625
p221011,4,10,10,24,1,0.4166666666666667
p221012,9,22,12,43,1,0.5116279069767442
p221020,11,9,10,30,0,0.36666666666666664
p221021,10,17,14,41,1,0.4146341463414634
p221022,10,16,10,36,1,0.4444444444444444
p221100,15,5,7,27,0,0.5555555555555556
p221101,9,9,10,28,2,0.35714285714285715
p221102,17,16,10,43,0,0.3953488372093023
p221110,6,12,9,27,1,0.4444444444444444
p221111,11,21,34,66,2,0.5151515151515151
p221112,14,36,24,74,1,0.4864864864864865
p221120,10,16,15,41,1,0.3902439024390244
p221121,13,33,51,97,2,0.5257731958762887
p221122,16,41,46,103,2,0.44660194174757284
p221200,14,11,5,30,0,0.4666666666666667
p221201,17,19,13,49,1,0.3877551020408163
p221202,6,26,10,42,1,0.6190476190476191
p221210,20,21,24,65,2,0.36923076923076925
p221211,18,37,38,93,2,0.40860215053763443
p221212,31,58,41,130,1,0.4461538461538462
p221220,9,17,9,35,1,0.4857142857142857
p221221,21,47,43,111,1,0.42342342342342343
p221222,12,47,31,90,1,0.5222222222222223
p222000,18,11,3,32,0,0.5625
p222001,6,6,7,19,2,0.3684210526315789
p222002,5,12,3,20,1,0.6
p222010,10,7,3,20,0,0.5
p222011,9,7,9,25,0,0.36
p222012,9,5,5,19,0,0.47368421052631576
p222020,3,8,4,15,1,0.5333333333333333
p222021,6,14,6,26,1,0.5384615384615384
p222022,6,12,3,21,1,0.5714285714285714
p222100,10,13,12,35,1,0.37142857142857144
p222101,15,8,10,33,0,0.45454545454545453
p222102,6,12,13,31,2,0.41935483870967744
p222110,8,7,12,27,2,0.4444444444444444
p222111,9,31,28,68,1,0.45588235294117646
p222112,14,38,33,85,1,0.4470588235294118
p222120,11,13,15,39,2,0.38461538461538464
p222121,24,35,59,118,2,0.5
p222122,11,43,31,85,1,0.5058823529411764
p222200,6,6,5,17,0,0.35294117647058826
p222201,4,8,6,18,1,0.4444444444444444
p222202,4,10,9,23,1,0.43478260869565216
p222210,7,9,9,25,1,0.36
p222211,11,30,29,70,1,0.42857142857142855
p222212,18,39,27,84,1,0.4642857142857143
p222220,3,4,7,14,2,0.5
p222221,9,27,30,66,2,0.45454545454545453
p222222,3,18,13,34,1,0.5294117647058824
